1111111111111111111111111111111111111111111111111111111111111111111111111111111111111
1000E1000010000000000000000000P00000000000000000000000000000000C000000000000000000001
1001110000100000000000000000000000000000000000000000000000000000000000000000000000001
1001000000100000000000000000000000000001110000000000000000000000000000000000000000001
1011000000100000000000000000000000000000001110000000000000000000000000000000000000001
1010000000100000000000000000000000000000000000000000000000000000000000000000000000001
1001000000100000000000000000000000000000000000000000000000000000000000000000000000001
1100100000100000000000000000000000000000000000000000000000000000000000000000000000001
1010010000100000000000000000000000000000000000000000000000000000000000000000000000001
1001001000100000000000000000000000000000000000000000000000000000000000000000000000001
1000100100100000000000000000000000000000000000000000000000000000000000000000000000001
1000010010100000000000000000000000000000000000000000000000000000000000000000000000001
1000000100100000000000000000000000000000000000000000000000000000000000000000000000001
1000001000100000000000000000000000000000000000000000000000000000000000000000000000001
1000010000100000000000000000000000000000000000000000000000000000000000000000000000001
1000100000100000000000000000000000000000000000000000000000000000000000000000000000001
1001000000100000000000000000000000000000000000000000000000000000000000000000000000001
1010000000100000000000000000000000000000000000000000000000000000000000000000000000001
1001000000100000000000000000000000000000000000000000000000000000000000000000000000001
1000100000100000000000000000000000000000000000000000000000000000000000000000000000001
1000010000100000000000000000000000000000000000000000000000000000000000000000000000001
1000001000100000000000000000000000000000000000000000000000000000000000000000000000001
1000000101000000000000000000000000000000000000000000000000000000000000000000000000001
1000000001000000000000000000000000000000000000000000000000000000000000000000000000001
1000000000100000000000000000000000000000000000000000000000000000000000000000000000001
1000000000100000000000000000000000000000000000000000000000000000000000000000000000001
1000000000010000000000000000000000000000000000000000000000000000000000000000000000001
1000000000010000000000000000000000000000000000000000000000000000000000000000000000001
1000000000010000000000000000000000000000000000000000000000000000000000000000000000001
1000000000010000000000000000000000000000000000000000000000000000000000000000000000001
1000000000010000000000000000000000000000000000000000000000000000000000000000000000001
1000000000010000000000000000000000000000000000000000000000000000000000000000000000001
1000000000010000000000000000000000000000000000000000000000000000000000000000000000001
1000000000010000000000000000000000000000000000000000000000000000000000000000000000001
1000000000010000000000100000000000000000000000000000000000000000000000000000000000001
1000000000010000001001000000000000000000000000000000000000000000000000000000000000001
1000000000001000010010000000000000000000000000000000000000000000000000000000000000001
1000000000001000100100000000000000000000000000000000000000000000000000000000000000001
1000000000001111001000000000000000000000000000000000000000000000000000000000000000001
1000000000000000010000000000000000000000000000000000000000000000000000000000000000001
1111111111111111111111111111111111111111111111111111111111111111111111111111111111111