1111111111111
1P000000000E1
1C11110111011
1C00010100001
1C11010101111
1C01010101001
1C01010101011
1001000100011
1011111111011
1C00000000001
1011011111011
1000010000011
1111111111111